1111111
1001111
10E00C1
1000C01
1101111
10PC111
1111111
1000001
1111111
