111111111
111100001
1P0001001
1000C1101
1E0111001
10011C001
110100001
1000001C1
111111111