111111111
111100001
1PC001001
100001101
100111001
1001100E1
11010C001
1C0000101
111111111
