11111111111111
1P110000C00011
10000100000001
11000110001E01
10011110001101
10011000100001
11010C00001101
1C0000100011C1
11111111111111
