11111111111111111111
10000100100110000001
1000P000000000001001
10000000100010000001
100C1000010000000001
10001100010000C01001
10000101000000100001
10001111100100000001
11000110010001110101
11111100010001110001
100001010100C1110001
1000000010000C000011
10101000110001011011
10010000100100000001
10000100000010100001
1011100C000000000011
10000000000000001011
10000001000011000111
110000000000000000E1
11111111111111111111
