11111111111111111111
11000000C0011100C001
1000P000000000000001
10000011100000001101
11C00001100010001101
1110000000001000E001
11111000C00110000001
11111111111111111111