11111111111111111111111111
11000000C0011100C0000000C1
1000P000000000000000001111
10000011100000001100000001
11C00001100010001100001C01
1110000000001000E000011101
11111000C00110000000001001
1110000000111100C000000001
11110000001111001111000001
1100001110000000100000C001
11000000C0011100C000000001
11111111111111111111111111